"XXXXXXXXXXXXXXXXXXXXXXXXX",
"XXXXXXXXXXXXXXX      XT X",
"XXXXXXXXXXXXXXX    OTXX X",
"XXXXXXXXXXXXXXXXX  OXGR X",
"XXXXXXXXXXXXXXXXXX TXG  X",
"XXXXXXXXXXXXXXXXXXXXXXX X",
"XXXXXXXXXXXXXXXXX    GR X",
"XXXXXXXXXXXXXXXXXXX     X",
"XXXXXXXXXXXX XXXXXXXXX RX",
"XXXXXXXXXXX   XXXXXXX   X",
"XXXXXXXXXX 1L  XXXXXX   L",
"XXXXXXXXX  LLL         LL",
"XXXXXXXXXX  L2 XXO   LLLL",
"XXXXXXXXXXX   XXX   LLLLL",
"XXXXXXXXXXXX XXXX  LLLLLL",
"XXXXXXXXXXXXXXXXX O XLLLL",
"XXXXXXXXXXXXXXXXX  TXXLLL",
"XXXXXXXXXXXXXXXXXXXXT LLL",
"XXXXXXXXXXXXXXXXXXXX   LL",
"XXXXXXXXXXXXXXXXXXXX   XL",
"XXXXXXXXXXXXXXXXXXXXXXXXX",
"XXXXXXXXXXXXXXXXXXXXXXXXX",
"XXXXXXXXXXXXXXXXXXXXXXXXX",
"XXXXXXXXXXXXXXXXXXXXXXXXX",
"XXXXXXXXXXXXXXXXXXXXXXXXX"

