"XXXLLLXXXXXXXXLLXXXXXXXXX",
"XT   LXTOX  LLLLLL   XT X",
"XXXX         LLLL  OTXX X",
"X RX XGR X O   L   OXGR X",
"X TX XXXXXTXO    X TXG  X",
"X XG   OOXXXXX  OOXXXXX X",
"X X                  GR X",
"X X RTR XXX   XXX  X    X",
"X    XXX TXX XX   RXXX RX",
"XRGX  X  XX   XTX  GXT  X",
"XXXX  O XX 1L  XX  RXO  L",
"X  TX      LLL         LL",
"X OX   LXX  L2 XXO   LLLL",
"X OX X LLXX   XX    LLLLL",
"X  X X XLLXX XXR  XLLLLLL",
"X GX    XLXX XRG  OTXLLLL",
"X RXX  XXXX  XGR    XXLLL",
"X   X   OXX  X   R XXT LL",
"X R    OOTX     G  XO  LL",
"X TXX     R R   XX  OO TL",
"XG XXXX X   GR  X      LL",
"XR XXG   XXXXXX    X LLLL",
"X   R     RRTGR X GXLLLLX",
"XTR   GXX         XLLLLLX",
"XXXXXXXXXXXXXXXXXXXXXXXXX"

