"XXLLLLXXXXXXXXXXXXXXXXXXX",
"LT   LLXO    RXXX   GXT X",
"LLLL  LXT OR  XXX X RXR X",
"L TX OXXXXXX      X  XG X",
"X RX    RGXXXXXXXXX     X",
"X GX  R  GXR TXXXXXXXXR X",
"X XX  XXXXXG XXXXXXXXX  X",
"X XX  XXXXXR XXXXXXXTR  X",
"X XX             XXX    X",
"X XXXXXXXXXXXXX  XXXXX  X",
"X  OXXOTXGGRXXR   RG    X",
"L   TX  XR      G    R  X",
"LL  XX XX     GRXXX XXXXX",
"LLL OX XX  XXXXXXR    XXX",
"LLL  X XX  XXXXGG  OOTXXX",
"LLL R      XXXXXXXXXXXXTX",
"LL    GR    XXX TXXT XX X",
"LL  XXXXXX   XX LLXL    X",
"L  XXXT  XX     RLLLXX  X",
"X  RXXXR XXXGR OXXLLLL OX",
"XO    XX GXXXR XXLLLLX OX",
"XO  RTXX RXXX     L     X",
"XXX XXXG  GR    X   XX XX",
"XT            XXXGRGX1 2X",
"XXXXXXXXXXXXXXXXXXXXXXXXX"