"XXXXXLLLLLLLLXXXXXXXXLLLL",
"X1 2XXLLLLLL        XXLLL",
"XX XXXXLLLL  XXXXXO XLLLX",
"X     LLLX  XXXXXX  XLLXX",
"XR     LLX  XXXRR  OO  TX",
"XGGXXX LXX  XXXT       XX",
"XXXXXX  XX  XXXXXRG XXXXX",
"XXXXXX  XX    RXXXR XXXXX",
"XTGXXX     GRTXXXXT XXXXX",
"X  XXX  XXXXXXXXXXXXXXXXX",
"X  RR    GXXXXXXXXXXXXXXX",
"XG    RG         XXXXXGXX",
"XXXXXXXXXXXXOOO  XXXGRTRX",
"XXXXXXXXXXXXXXX  XXXGR  X",
"XXX TRXXXXXXXXX  R    R X",
"XXX R   O           R   X",
"XXX   O     XXXXXXXXXXXXX",
"XXXXXXLLLX  XXXXXXXXXXXXX",
"XXXXLLLLXX      O    RRTX",
"XXT XLXXXX   O          X",
"LX  OXXXXXXXXXXXXX  XXXXX",
"LL  OOXXXXXXXXXXRX  XXGGX",
"LLL  OO   GRGXXXGR     RX",
"LLLL                 R TX",
"LLLLLXXXXXXXXXXXXXXXXXXXX"
    