"XXXXXXXXXXXXXXXXXXXXXXXXX",
"X     XX      XXXXXXXXXXX",
"XXXX  XX      XXXXXXXXXXX",
"XXXX  XXXXXXXXXXXXXXXXXXX",
"XXXX      XXXXXXXXXXXXXXX",
"XXXX      X   XXXXXXXXXXX",
"XXXX  XXXXX  XXXXXXXXXXXX",
"XXXX  XXXXX  XXXXXXXXXXXX",
"XXXX             XXXXXXXX",
"XXXXXXXXXXXXXXX  XXXXXXXX",
"X   XXXXXXXXXXX         X",
"X    XXXX               X",
"XXX  X XX        XXXXXXXX",
"XXX  X XX  XXXXXXXXXXXXXX",
"XXX  X XX  XXXXXXXXXXXXXX",
"XXX        XXXXXXXXXXXXXX",
"XXX        XXXXXXXXXXXXXX",
"XXXXXXXXXXXXXXXXXXXXXXXXX",
"XXXXXXXXXXXXXXXXXXXXXXXXX",
"XXXXXXXXXXXXXXXXXXXXXXXXX",
"XXXXXXXXXXXXXXXXXXXXXXXXX",
"XXXXXXXXXXXXXXXXXXXXXXXXX",
"XXXXXXXXXXXXXXXXXXXXXXXXX",
"XXXXXXXXXXXXXXXXXXXXXXXXX",
"XXXXXXXXXXXXXXXXXXXXXXXXX"